############I#################################
#                     #     #     #          #
# ############## ###### ####### ############ #
# #  #  #                     #        #   # #
# # ### # ################### ##### #### # # #
# # #   # #                 #          # #   #
# # ### # ##### ##### ##### #  ######### #####
#         #       #   # # # #                #
######## ## ##### # # #   # ########## ##### #
#           #   # # # ### #   #      #     # #
##### ######### # # #     ## ## # ####  ## ###
#               #   # #####   # # #  # ###   #
# ### ### #### ### ## #   ##### ###    #   # #
#####  #     # #####  # #         # ##########
#   ## # #####  ## #### # #########     #    #
# ###  #     ####       # #   #   ####### ## #
#     #  # #      #######   #   #         #  #
###########################################O##